layer,sentence,train_acc,test_acc,n_samples,n_train,n_test
0,0,1.0,0.6363636363636364,55,44,11
0,1,1.0,0.5454545454545454,55,44,11
0,2,1.0,0.6363636363636364,55,44,11
0,3,1.0,0.36363636363636365,55,44,11
0,4,1.0,0.6363636363636364,55,44,11
0,5,1.0,0.5454545454545454,55,44,11
0,6,1.0,0.36363636363636365,54,43,11
0,7,1.0,0.45454545454545453,54,43,11
0,8,1.0,0.45454545454545453,54,43,11
0,9,1.0,0.36363636363636365,53,42,11
0,10,1.0,0.5454545454545454,53,42,11
0,11,1.0,0.45454545454545453,53,42,11
0,12,1.0,0.45454545454545453,52,41,11
0,13,1.0,0.6,49,39,10
0,14,1.0,0.5555555555555556,43,34,9
0,15,1.0,0.3333333333333333,35,29,6
0,16,1.0,0.4,31,26,5
0,17,1.0,0.6,29,24,5
0,18,1.0,0.5,27,23,4
0,19,1.0,0.5,25,21,4
0,20,1.0,0.5,24,20,4
0,21,1.0,0.5,23,19,4
0,22,1.0,0.5,22,18,4
0,23,1.0,0.3333333333333333,20,17,3
1,0,1.0,0.6363636363636364,55,44,11
1,1,1.0,0.5454545454545454,55,44,11
1,2,1.0,0.5454545454545454,55,44,11
1,3,1.0,0.36363636363636365,55,44,11
1,4,1.0,0.6363636363636364,55,44,11
1,5,1.0,0.5454545454545454,55,44,11
1,6,1.0,0.36363636363636365,54,43,11
1,7,1.0,0.45454545454545453,54,43,11
1,8,1.0,0.45454545454545453,54,43,11
1,9,1.0,0.36363636363636365,53,42,11
1,10,1.0,0.5454545454545454,53,42,11
1,11,1.0,0.45454545454545453,53,42,11
1,12,1.0,0.5454545454545454,52,41,11
1,13,1.0,0.6,49,39,10
1,14,1.0,0.3333333333333333,43,34,9
1,15,1.0,0.3333333333333333,35,29,6
1,16,1.0,0.4,31,26,5
1,17,1.0,0.6,29,24,5
1,18,1.0,0.5,27,23,4
1,19,1.0,0.5,25,21,4
1,20,1.0,0.5,24,20,4
1,21,1.0,0.5,23,19,4
1,22,1.0,0.5,22,18,4
1,23,1.0,0.3333333333333333,20,17,3
2,0,1.0,0.7272727272727273,55,44,11
2,1,1.0,0.6363636363636364,55,44,11
2,2,1.0,0.45454545454545453,55,44,11
2,3,1.0,0.45454545454545453,55,44,11
2,4,1.0,0.6363636363636364,55,44,11
2,5,1.0,0.45454545454545453,55,44,11
2,6,1.0,0.5454545454545454,54,43,11
2,7,1.0,0.2727272727272727,54,43,11
2,8,1.0,0.45454545454545453,54,43,11
2,9,1.0,0.5454545454545454,53,42,11
2,10,1.0,0.5454545454545454,53,42,11
2,11,1.0,0.45454545454545453,53,42,11
2,12,1.0,0.5454545454545454,52,41,11
2,13,1.0,0.7,49,39,10
2,14,1.0,0.3333333333333333,43,34,9
2,15,1.0,0.3333333333333333,35,29,6
2,16,1.0,0.4,31,26,5
2,17,1.0,0.6,29,24,5
2,18,1.0,0.5,27,23,4
2,19,1.0,0.5,25,21,4
2,20,1.0,0.5,24,20,4
2,21,1.0,0.5,23,19,4
2,22,1.0,0.5,22,18,4
2,23,1.0,0.3333333333333333,20,17,3
3,0,1.0,0.7272727272727273,55,44,11
3,1,1.0,0.6363636363636364,55,44,11
3,2,1.0,0.45454545454545453,55,44,11
3,3,1.0,0.36363636363636365,55,44,11
3,4,1.0,0.7272727272727273,55,44,11
3,5,1.0,0.45454545454545453,55,44,11
3,6,1.0,0.5454545454545454,54,43,11
3,7,1.0,0.36363636363636365,54,43,11
3,8,1.0,0.36363636363636365,54,43,11
3,9,1.0,0.5454545454545454,53,42,11
3,10,1.0,0.45454545454545453,53,42,11
3,11,1.0,0.45454545454545453,53,42,11
3,12,1.0,0.45454545454545453,52,41,11
3,13,1.0,0.7,49,39,10
3,14,1.0,0.2222222222222222,43,34,9
3,15,1.0,0.3333333333333333,35,29,6
3,16,1.0,0.4,31,26,5
3,17,1.0,0.6,29,24,5
3,18,1.0,0.5,27,23,4
3,19,1.0,0.5,25,21,4
3,20,1.0,0.5,24,20,4
3,21,1.0,0.5,23,19,4
3,22,1.0,0.5,22,18,4
3,23,1.0,0.3333333333333333,20,17,3
4,0,1.0,0.7272727272727273,55,44,11
4,1,1.0,0.6363636363636364,55,44,11
4,2,1.0,0.5454545454545454,55,44,11
4,3,1.0,0.36363636363636365,55,44,11
4,4,1.0,0.6363636363636364,55,44,11
4,5,1.0,0.45454545454545453,55,44,11
4,6,1.0,0.6363636363636364,54,43,11
4,7,1.0,0.36363636363636365,54,43,11
4,8,1.0,0.36363636363636365,54,43,11
4,9,1.0,0.5454545454545454,53,42,11
4,10,1.0,0.45454545454545453,53,42,11
4,11,1.0,0.45454545454545453,53,42,11
4,12,1.0,0.45454545454545453,52,41,11
4,13,1.0,0.6,49,39,10
4,14,1.0,0.4444444444444444,43,34,9
4,15,1.0,0.3333333333333333,35,29,6
4,16,1.0,0.4,31,26,5
4,17,1.0,0.6,29,24,5
4,18,1.0,0.5,27,23,4
4,19,1.0,0.5,25,21,4
4,20,1.0,0.5,24,20,4
4,21,1.0,0.5,23,19,4
4,22,1.0,0.5,22,18,4
4,23,1.0,0.3333333333333333,20,17,3
5,0,1.0,0.6363636363636364,55,44,11
5,1,1.0,0.5454545454545454,55,44,11
5,2,1.0,0.5454545454545454,55,44,11
5,3,1.0,0.45454545454545453,55,44,11
5,4,1.0,0.6363636363636364,55,44,11
5,5,1.0,0.45454545454545453,55,44,11
5,6,1.0,0.5454545454545454,54,43,11
5,7,1.0,0.36363636363636365,54,43,11
5,8,1.0,0.5454545454545454,54,43,11
5,9,1.0,0.5454545454545454,53,42,11
5,10,1.0,0.45454545454545453,53,42,11
5,11,1.0,0.5454545454545454,53,42,11
5,12,1.0,0.45454545454545453,52,41,11
5,13,1.0,0.8,49,39,10
5,14,1.0,0.3333333333333333,43,34,9
5,15,1.0,0.3333333333333333,35,29,6
5,16,1.0,0.4,31,26,5
5,17,1.0,0.6,29,24,5
5,18,1.0,0.5,27,23,4
5,19,1.0,0.5,25,21,4
5,20,1.0,0.5,24,20,4
5,21,1.0,0.5,23,19,4
5,22,1.0,0.5,22,18,4
5,23,1.0,0.3333333333333333,20,17,3
6,0,1.0,0.5454545454545454,55,44,11
6,1,1.0,0.5454545454545454,55,44,11
6,2,1.0,0.6363636363636364,55,44,11
6,3,1.0,0.36363636363636365,55,44,11
6,4,1.0,0.6363636363636364,55,44,11
6,5,1.0,0.5454545454545454,55,44,11
6,6,1.0,0.5454545454545454,54,43,11
6,7,1.0,0.2727272727272727,54,43,11
6,8,1.0,0.45454545454545453,54,43,11
6,9,1.0,0.45454545454545453,53,42,11
6,10,1.0,0.45454545454545453,53,42,11
6,11,1.0,0.6363636363636364,53,42,11
6,12,1.0,0.45454545454545453,52,41,11
6,13,1.0,0.6,49,39,10
6,14,1.0,0.3333333333333333,43,34,9
6,15,1.0,0.3333333333333333,35,29,6
6,16,1.0,0.4,31,26,5
6,17,1.0,0.6,29,24,5
6,18,1.0,0.5,27,23,4
6,19,1.0,0.5,25,21,4
6,20,1.0,0.5,24,20,4
6,21,1.0,0.5,23,19,4
6,22,1.0,0.5,22,18,4
6,23,1.0,0.3333333333333333,20,17,3
7,0,1.0,0.5454545454545454,55,44,11
7,1,1.0,0.5454545454545454,55,44,11
7,2,1.0,0.6363636363636364,55,44,11
7,3,1.0,0.36363636363636365,55,44,11
7,4,1.0,0.6363636363636364,55,44,11
7,5,1.0,0.45454545454545453,55,44,11
7,6,1.0,0.45454545454545453,54,43,11
7,7,1.0,0.2727272727272727,54,43,11
7,8,1.0,0.45454545454545453,54,43,11
7,9,1.0,0.45454545454545453,53,42,11
7,10,1.0,0.5454545454545454,53,42,11
7,11,1.0,0.6363636363636364,53,42,11
7,12,1.0,0.45454545454545453,52,41,11
7,13,1.0,0.7,49,39,10
7,14,1.0,0.3333333333333333,43,34,9
7,15,1.0,0.3333333333333333,35,29,6
7,16,1.0,0.4,31,26,5
7,17,1.0,0.8,29,24,5
7,18,1.0,0.5,27,23,4
7,19,1.0,0.5,25,21,4
7,20,1.0,0.5,24,20,4
7,21,1.0,0.5,23,19,4
7,22,1.0,0.5,22,18,4
7,23,1.0,0.3333333333333333,20,17,3
8,0,1.0,0.5454545454545454,55,44,11
8,1,1.0,0.5454545454545454,55,44,11
8,2,1.0,0.6363636363636364,55,44,11
8,3,1.0,0.36363636363636365,55,44,11
8,4,1.0,0.6363636363636364,55,44,11
8,5,1.0,0.45454545454545453,55,44,11
8,6,1.0,0.5454545454545454,54,43,11
8,7,1.0,0.2727272727272727,54,43,11
8,8,1.0,0.45454545454545453,54,43,11
8,9,1.0,0.45454545454545453,53,42,11
8,10,1.0,0.45454545454545453,53,42,11
8,11,1.0,0.6363636363636364,53,42,11
8,12,1.0,0.45454545454545453,52,41,11
8,13,1.0,0.7,49,39,10
8,14,1.0,0.3333333333333333,43,34,9
8,15,1.0,0.3333333333333333,35,29,6
8,16,1.0,0.4,31,26,5
8,17,1.0,0.6,29,24,5
8,18,1.0,0.5,27,23,4
8,19,1.0,0.5,25,21,4
8,20,1.0,0.5,24,20,4
8,21,1.0,0.5,23,19,4
8,22,1.0,0.5,22,18,4
8,23,1.0,0.3333333333333333,20,17,3
9,0,1.0,0.5454545454545454,55,44,11
9,1,1.0,0.5454545454545454,55,44,11
9,2,1.0,0.6363636363636364,55,44,11
9,3,1.0,0.36363636363636365,55,44,11
9,4,1.0,0.6363636363636364,55,44,11
9,5,1.0,0.45454545454545453,55,44,11
9,6,1.0,0.5454545454545454,54,43,11
9,7,1.0,0.36363636363636365,54,43,11
9,8,1.0,0.45454545454545453,54,43,11
9,9,1.0,0.5454545454545454,53,42,11
9,10,1.0,0.5454545454545454,53,42,11
9,11,1.0,0.6363636363636364,53,42,11
9,12,1.0,0.45454545454545453,52,41,11
9,13,1.0,0.6,49,39,10
9,14,1.0,0.4444444444444444,43,34,9
9,15,1.0,0.3333333333333333,35,29,6
9,16,1.0,0.4,31,26,5
9,17,1.0,0.6,29,24,5
9,18,1.0,0.5,27,23,4
9,19,1.0,0.5,25,21,4
9,20,1.0,0.5,24,20,4
9,21,1.0,0.5,23,19,4
9,22,1.0,0.5,22,18,4
9,23,1.0,0.3333333333333333,20,17,3
10,0,1.0,0.5454545454545454,55,44,11
10,1,1.0,0.5454545454545454,55,44,11
10,2,1.0,0.5454545454545454,55,44,11
10,3,1.0,0.36363636363636365,55,44,11
10,4,1.0,0.6363636363636364,55,44,11
10,5,1.0,0.45454545454545453,55,44,11
10,6,1.0,0.5454545454545454,54,43,11
10,7,1.0,0.36363636363636365,54,43,11
10,8,1.0,0.6363636363636364,54,43,11
10,9,1.0,0.5454545454545454,53,42,11
10,10,1.0,0.6363636363636364,53,42,11
10,11,1.0,0.5454545454545454,53,42,11
10,12,1.0,0.45454545454545453,52,41,11
10,13,1.0,0.6,49,39,10
10,14,1.0,0.4444444444444444,43,34,9
10,15,1.0,0.3333333333333333,35,29,6
10,16,1.0,0.4,31,26,5
10,17,1.0,0.4,29,24,5
10,18,1.0,0.5,27,23,4
10,19,1.0,0.5,25,21,4
10,20,1.0,0.5,24,20,4
10,21,1.0,0.5,23,19,4
10,22,1.0,0.5,22,18,4
10,23,1.0,0.3333333333333333,20,17,3
11,0,1.0,0.5454545454545454,55,44,11
11,1,1.0,0.5454545454545454,55,44,11
11,2,1.0,0.5454545454545454,55,44,11
11,3,1.0,0.36363636363636365,55,44,11
11,4,1.0,0.6363636363636364,55,44,11
11,5,1.0,0.45454545454545453,55,44,11
11,6,1.0,0.45454545454545453,54,43,11
11,7,1.0,0.36363636363636365,54,43,11
11,8,1.0,0.5454545454545454,54,43,11
11,9,1.0,0.45454545454545453,53,42,11
11,10,1.0,0.7272727272727273,53,42,11
11,11,1.0,0.5454545454545454,53,42,11
11,12,1.0,0.45454545454545453,52,41,11
11,13,1.0,0.6,49,39,10
11,14,1.0,0.4444444444444444,43,34,9
11,15,1.0,0.3333333333333333,35,29,6
11,16,1.0,0.6,31,26,5
11,17,1.0,0.4,29,24,5
11,18,1.0,0.5,27,23,4
11,19,1.0,0.5,25,21,4
11,20,1.0,0.5,24,20,4
11,21,1.0,0.5,23,19,4
11,22,1.0,0.5,22,18,4
11,23,1.0,0.3333333333333333,20,17,3
12,0,1.0,0.5454545454545454,55,44,11
12,1,1.0,0.5454545454545454,55,44,11
12,2,1.0,0.5454545454545454,55,44,11
12,3,1.0,0.36363636363636365,55,44,11
12,4,1.0,0.6363636363636364,55,44,11
12,5,1.0,0.45454545454545453,55,44,11
12,6,1.0,0.5454545454545454,54,43,11
12,7,1.0,0.45454545454545453,54,43,11
12,8,1.0,0.45454545454545453,54,43,11
12,9,1.0,0.45454545454545453,53,42,11
12,10,1.0,0.45454545454545453,53,42,11
12,11,1.0,0.5454545454545454,53,42,11
12,12,1.0,0.45454545454545453,52,41,11
12,13,1.0,0.6,49,39,10
12,14,1.0,0.3333333333333333,43,34,9
12,15,1.0,0.5,35,29,6
12,16,1.0,0.4,31,26,5
12,17,1.0,0.6,29,24,5
12,18,1.0,0.5,27,23,4
12,19,1.0,0.5,25,21,4
12,20,1.0,0.5,24,20,4
12,21,1.0,0.5,23,19,4
12,22,1.0,0.5,22,18,4
12,23,1.0,0.3333333333333333,20,17,3
13,0,1.0,0.45454545454545453,55,44,11
13,1,1.0,0.5454545454545454,55,44,11
13,2,1.0,0.6363636363636364,55,44,11
13,3,1.0,0.45454545454545453,55,44,11
13,4,1.0,0.6363636363636364,55,44,11
13,5,1.0,0.5454545454545454,55,44,11
13,6,1.0,0.45454545454545453,54,43,11
13,7,1.0,0.45454545454545453,54,43,11
13,8,1.0,0.5454545454545454,54,43,11
13,9,1.0,0.5454545454545454,53,42,11
13,10,1.0,0.6363636363636364,53,42,11
13,11,1.0,0.6363636363636364,53,42,11
13,12,1.0,0.36363636363636365,52,41,11
13,13,1.0,0.6,49,39,10
13,14,1.0,0.3333333333333333,43,34,9
13,15,1.0,0.5,35,29,6
13,16,1.0,0.6,31,26,5
13,17,1.0,0.6,29,24,5
13,18,1.0,0.5,27,23,4
13,19,1.0,0.5,25,21,4
13,20,1.0,0.5,24,20,4
13,21,1.0,0.5,23,19,4
13,22,1.0,0.5,22,18,4
13,23,1.0,0.3333333333333333,20,17,3
14,0,1.0,0.45454545454545453,55,44,11
14,1,1.0,0.45454545454545453,55,44,11
14,2,1.0,0.6363636363636364,55,44,11
14,3,1.0,0.45454545454545453,55,44,11
14,4,1.0,0.6363636363636364,55,44,11
14,5,1.0,0.5454545454545454,55,44,11
14,6,1.0,0.5454545454545454,54,43,11
14,7,1.0,0.45454545454545453,54,43,11
14,8,1.0,0.5454545454545454,54,43,11
14,9,1.0,0.45454545454545453,53,42,11
14,10,1.0,0.45454545454545453,53,42,11
14,11,1.0,0.6363636363636364,53,42,11
14,12,1.0,0.45454545454545453,52,41,11
14,13,1.0,0.6,49,39,10
14,14,1.0,0.4444444444444444,43,34,9
14,15,1.0,0.3333333333333333,35,29,6
14,16,1.0,0.6,31,26,5
14,17,1.0,0.6,29,24,5
14,18,1.0,0.5,27,23,4
14,19,1.0,0.5,25,21,4
14,20,1.0,0.5,24,20,4
14,21,1.0,0.5,23,19,4
14,22,1.0,0.5,22,18,4
14,23,1.0,0.3333333333333333,20,17,3
15,0,1.0,0.45454545454545453,55,44,11
15,1,1.0,0.45454545454545453,55,44,11
15,2,1.0,0.6363636363636364,55,44,11
15,3,1.0,0.45454545454545453,55,44,11
15,4,1.0,0.6363636363636364,55,44,11
15,5,1.0,0.45454545454545453,55,44,11
15,6,1.0,0.5454545454545454,54,43,11
15,7,1.0,0.5454545454545454,54,43,11
15,8,1.0,0.5454545454545454,54,43,11
15,9,1.0,0.45454545454545453,53,42,11
15,10,1.0,0.5454545454545454,53,42,11
15,11,1.0,0.5454545454545454,53,42,11
15,12,1.0,0.36363636363636365,52,41,11
15,13,1.0,0.6,49,39,10
15,14,1.0,0.4444444444444444,43,34,9
15,15,1.0,0.3333333333333333,35,29,6
15,16,1.0,0.4,31,26,5
15,17,1.0,0.6,29,24,5
15,18,1.0,0.5,27,23,4
15,19,1.0,0.5,25,21,4
15,20,1.0,0.5,24,20,4
15,21,1.0,0.5,23,19,4
15,22,1.0,0.5,22,18,4
15,23,1.0,0.3333333333333333,20,17,3
16,0,1.0,0.45454545454545453,55,44,11
16,1,1.0,0.45454545454545453,55,44,11
16,2,1.0,0.6363636363636364,55,44,11
16,3,1.0,0.45454545454545453,55,44,11
16,4,1.0,0.6363636363636364,55,44,11
16,5,1.0,0.5454545454545454,55,44,11
16,6,1.0,0.5454545454545454,54,43,11
16,7,1.0,0.6363636363636364,54,43,11
16,8,1.0,0.5454545454545454,54,43,11
16,9,1.0,0.45454545454545453,53,42,11
16,10,1.0,0.6363636363636364,53,42,11
16,11,1.0,0.6363636363636364,53,42,11
16,12,1.0,0.36363636363636365,52,41,11
16,13,1.0,0.6,49,39,10
16,14,1.0,0.4444444444444444,43,34,9
16,15,1.0,0.3333333333333333,35,29,6
16,16,1.0,0.4,31,26,5
16,17,1.0,0.4,29,24,5
16,18,1.0,0.5,27,23,4
16,19,1.0,0.5,25,21,4
16,20,1.0,0.5,24,20,4
16,21,1.0,0.5,23,19,4
16,22,1.0,0.5,22,18,4
16,23,1.0,0.3333333333333333,20,17,3
17,0,1.0,0.45454545454545453,55,44,11
17,1,1.0,0.45454545454545453,55,44,11
17,2,1.0,0.5454545454545454,55,44,11
17,3,1.0,0.5454545454545454,55,44,11
17,4,1.0,0.6363636363636364,55,44,11
17,5,1.0,0.45454545454545453,55,44,11
17,6,1.0,0.6363636363636364,54,43,11
17,7,1.0,0.6363636363636364,54,43,11
17,8,1.0,0.5454545454545454,54,43,11
17,9,1.0,0.45454545454545453,53,42,11
17,10,1.0,0.7272727272727273,53,42,11
17,11,1.0,0.6363636363636364,53,42,11
17,12,1.0,0.36363636363636365,52,41,11
17,13,1.0,0.7,49,39,10
17,14,1.0,0.3333333333333333,43,34,9
17,15,1.0,0.3333333333333333,35,29,6
17,16,1.0,0.4,31,26,5
17,17,1.0,0.4,29,24,5
17,18,1.0,0.5,27,23,4
17,19,1.0,0.5,25,21,4
17,20,1.0,0.5,24,20,4
17,21,1.0,0.5,23,19,4
17,22,1.0,0.5,22,18,4
17,23,1.0,0.3333333333333333,20,17,3
18,0,1.0,0.45454545454545453,55,44,11
18,1,1.0,0.45454545454545453,55,44,11
18,2,1.0,0.5454545454545454,55,44,11
18,3,1.0,0.45454545454545453,55,44,11
18,4,1.0,0.6363636363636364,55,44,11
18,5,1.0,0.45454545454545453,55,44,11
18,6,1.0,0.5454545454545454,54,43,11
18,7,1.0,0.5454545454545454,54,43,11
18,8,1.0,0.5454545454545454,54,43,11
18,9,1.0,0.45454545454545453,53,42,11
18,10,1.0,0.6363636363636364,53,42,11
18,11,1.0,0.6363636363636364,53,42,11
18,12,1.0,0.6363636363636364,52,41,11
18,13,1.0,0.7,49,39,10
18,14,1.0,0.4444444444444444,43,34,9
18,15,1.0,0.3333333333333333,35,29,6
18,16,1.0,0.4,31,26,5
18,17,1.0,0.6,29,24,5
18,18,1.0,0.5,27,23,4
18,19,1.0,0.5,25,21,4
18,20,1.0,0.5,24,20,4
18,21,1.0,0.5,23,19,4
18,22,1.0,0.5,22,18,4
18,23,1.0,0.6666666666666666,20,17,3
19,0,1.0,0.45454545454545453,55,44,11
19,1,1.0,0.45454545454545453,55,44,11
19,2,1.0,0.5454545454545454,55,44,11
19,3,1.0,0.45454545454545453,55,44,11
19,4,1.0,0.6363636363636364,55,44,11
19,5,1.0,0.36363636363636365,55,44,11
19,6,1.0,0.5454545454545454,54,43,11
19,7,1.0,0.5454545454545454,54,43,11
19,8,1.0,0.5454545454545454,54,43,11
19,9,1.0,0.45454545454545453,53,42,11
19,10,1.0,0.6363636363636364,53,42,11
19,11,1.0,0.5454545454545454,53,42,11
19,12,1.0,0.45454545454545453,52,41,11
19,13,1.0,0.6,49,39,10
19,14,1.0,0.3333333333333333,43,34,9
19,15,1.0,0.3333333333333333,35,29,6
19,16,1.0,0.4,31,26,5
19,17,1.0,0.6,29,24,5
19,18,1.0,0.5,27,23,4
19,19,1.0,0.5,25,21,4
19,20,1.0,0.5,24,20,4
19,21,1.0,0.5,23,19,4
19,22,1.0,0.5,22,18,4
19,23,1.0,0.3333333333333333,20,17,3
20,0,1.0,0.45454545454545453,55,44,11
20,1,1.0,0.5454545454545454,55,44,11
20,2,1.0,0.5454545454545454,55,44,11
20,3,1.0,0.36363636363636365,55,44,11
20,4,1.0,0.6363636363636364,55,44,11
20,5,1.0,0.36363636363636365,55,44,11
20,6,1.0,0.5454545454545454,54,43,11
20,7,1.0,0.6363636363636364,54,43,11
20,8,1.0,0.5454545454545454,54,43,11
20,9,1.0,0.36363636363636365,53,42,11
20,10,1.0,0.5454545454545454,53,42,11
20,11,1.0,0.5454545454545454,53,42,11
20,12,1.0,0.45454545454545453,52,41,11
20,13,1.0,0.6,49,39,10
20,14,1.0,0.3333333333333333,43,34,9
20,15,1.0,0.3333333333333333,35,29,6
20,16,1.0,0.4,31,26,5
20,17,1.0,0.4,29,24,5
20,18,1.0,0.5,27,23,4
20,19,1.0,0.5,25,21,4
20,20,1.0,0.5,24,20,4
20,21,1.0,0.5,23,19,4
20,22,1.0,0.5,22,18,4
20,23,1.0,1.0,20,17,3
21,0,1.0,0.45454545454545453,55,44,11
21,1,1.0,0.5454545454545454,55,44,11
21,2,1.0,0.5454545454545454,55,44,11
21,3,1.0,0.5454545454545454,55,44,11
21,4,1.0,0.5454545454545454,55,44,11
21,5,1.0,0.5454545454545454,55,44,11
21,6,1.0,0.45454545454545453,54,43,11
21,7,1.0,0.5454545454545454,54,43,11
21,8,1.0,0.5454545454545454,54,43,11
21,9,1.0,0.36363636363636365,53,42,11
21,10,1.0,0.5454545454545454,53,42,11
21,11,1.0,0.6363636363636364,53,42,11
21,12,1.0,0.45454545454545453,52,41,11
21,13,1.0,0.6,49,39,10
21,14,1.0,0.2222222222222222,43,34,9
21,15,1.0,0.3333333333333333,35,29,6
21,16,1.0,0.4,31,26,5
21,17,1.0,0.4,29,24,5
21,18,1.0,0.5,27,23,4
21,19,1.0,0.5,25,21,4
21,20,1.0,0.5,24,20,4
21,21,1.0,0.5,23,19,4
21,22,1.0,0.5,22,18,4
21,23,1.0,1.0,20,17,3
22,0,1.0,0.45454545454545453,55,44,11
22,1,1.0,0.5454545454545454,55,44,11
22,2,1.0,0.5454545454545454,55,44,11
22,3,1.0,0.5454545454545454,55,44,11
22,4,1.0,0.6363636363636364,55,44,11
22,5,1.0,0.45454545454545453,55,44,11
22,6,1.0,0.45454545454545453,54,43,11
22,7,1.0,0.6363636363636364,54,43,11
22,8,1.0,0.5454545454545454,54,43,11
22,9,1.0,0.36363636363636365,53,42,11
22,10,1.0,0.36363636363636365,53,42,11
22,11,1.0,0.6363636363636364,53,42,11
22,12,1.0,0.5454545454545454,52,41,11
22,13,1.0,0.5,49,39,10
22,14,1.0,0.3333333333333333,43,34,9
22,15,1.0,0.3333333333333333,35,29,6
22,16,1.0,0.4,31,26,5
22,17,1.0,0.4,29,24,5
22,18,1.0,0.5,27,23,4
22,19,1.0,0.5,25,21,4
22,20,1.0,0.75,24,20,4
22,21,1.0,0.5,23,19,4
22,22,1.0,0.5,22,18,4
22,23,1.0,1.0,20,17,3
23,0,1.0,0.45454545454545453,55,44,11
23,1,1.0,0.5454545454545454,55,44,11
23,2,1.0,0.5454545454545454,55,44,11
23,3,1.0,0.5454545454545454,55,44,11
23,4,1.0,0.6363636363636364,55,44,11
23,5,1.0,0.36363636363636365,55,44,11
23,6,1.0,0.45454545454545453,54,43,11
23,7,1.0,0.7272727272727273,54,43,11
23,8,1.0,0.7272727272727273,54,43,11
23,9,1.0,0.45454545454545453,53,42,11
23,10,1.0,0.45454545454545453,53,42,11
23,11,1.0,0.6363636363636364,53,42,11
23,12,1.0,0.5454545454545454,52,41,11
23,13,1.0,0.5,49,39,10
23,14,1.0,0.2222222222222222,43,34,9
23,15,1.0,0.3333333333333333,35,29,6
23,16,1.0,0.4,31,26,5
23,17,1.0,0.4,29,24,5
23,18,1.0,0.5,27,23,4
23,19,1.0,0.5,25,21,4
23,20,1.0,0.75,24,20,4
23,21,1.0,0.75,23,19,4
23,22,1.0,0.5,22,18,4
23,23,1.0,1.0,20,17,3
24,0,1.0,0.45454545454545453,55,44,11
24,1,1.0,0.5454545454545454,55,44,11
24,2,1.0,0.5454545454545454,55,44,11
24,3,1.0,0.5454545454545454,55,44,11
24,4,1.0,0.45454545454545453,55,44,11
24,5,1.0,0.36363636363636365,55,44,11
24,6,1.0,0.45454545454545453,54,43,11
24,7,1.0,0.5454545454545454,54,43,11
24,8,1.0,0.6363636363636364,54,43,11
24,9,1.0,0.45454545454545453,53,42,11
24,10,1.0,0.36363636363636365,53,42,11
24,11,1.0,0.6363636363636364,53,42,11
24,12,1.0,0.5454545454545454,52,41,11
24,13,1.0,0.5,49,39,10
24,14,1.0,0.3333333333333333,43,34,9
24,15,1.0,0.3333333333333333,35,29,6
24,16,1.0,0.4,31,26,5
24,17,1.0,0.4,29,24,5
24,18,1.0,0.5,27,23,4
24,19,1.0,0.5,25,21,4
24,20,1.0,0.5,24,20,4
24,21,1.0,0.75,23,19,4
24,22,1.0,0.5,22,18,4
24,23,1.0,1.0,20,17,3
25,0,1.0,0.45454545454545453,55,44,11
25,1,1.0,0.6363636363636364,55,44,11
25,2,1.0,0.5454545454545454,55,44,11
25,3,1.0,0.5454545454545454,55,44,11
25,4,1.0,0.6363636363636364,55,44,11
25,5,1.0,0.5454545454545454,55,44,11
25,6,1.0,0.45454545454545453,54,43,11
25,7,1.0,0.45454545454545453,54,43,11
25,8,1.0,0.7272727272727273,54,43,11
25,9,1.0,0.45454545454545453,53,42,11
25,10,1.0,0.45454545454545453,53,42,11
25,11,1.0,0.5454545454545454,53,42,11
25,12,1.0,0.45454545454545453,52,41,11
25,13,1.0,0.6,49,39,10
25,14,1.0,0.2222222222222222,43,34,9
25,15,1.0,0.3333333333333333,35,29,6
25,16,1.0,0.4,31,26,5
25,17,1.0,0.6,29,24,5
25,18,1.0,0.5,27,23,4
25,19,1.0,0.5,25,21,4
25,20,1.0,0.75,24,20,4
25,21,1.0,0.75,23,19,4
25,22,1.0,0.5,22,18,4
25,23,1.0,1.0,20,17,3
26,0,1.0,0.45454545454545453,55,44,11
26,1,1.0,0.6363636363636364,55,44,11
26,2,1.0,0.45454545454545453,55,44,11
26,3,1.0,0.45454545454545453,55,44,11
26,4,1.0,0.6363636363636364,55,44,11
26,5,1.0,0.5454545454545454,55,44,11
26,6,1.0,0.45454545454545453,54,43,11
26,7,1.0,0.45454545454545453,54,43,11
26,8,1.0,0.7272727272727273,54,43,11
26,9,1.0,0.36363636363636365,53,42,11
26,10,1.0,0.45454545454545453,53,42,11
26,11,1.0,0.5454545454545454,53,42,11
26,12,1.0,0.5454545454545454,52,41,11
26,13,1.0,0.5,49,39,10
26,14,1.0,0.2222222222222222,43,34,9
26,15,1.0,0.3333333333333333,35,29,6
26,16,1.0,0.4,31,26,5
26,17,1.0,0.4,29,24,5
26,18,1.0,0.5,27,23,4
26,19,1.0,0.5,25,21,4
26,20,1.0,0.75,24,20,4
26,21,1.0,0.75,23,19,4
26,22,1.0,0.5,22,18,4
26,23,1.0,0.6666666666666666,20,17,3
27,0,1.0,0.45454545454545453,55,44,11
27,1,1.0,0.5454545454545454,55,44,11
27,2,1.0,0.5454545454545454,55,44,11
27,3,1.0,0.5454545454545454,55,44,11
27,4,1.0,0.5454545454545454,55,44,11
27,5,1.0,0.5454545454545454,55,44,11
27,6,1.0,0.45454545454545453,54,43,11
27,7,1.0,0.45454545454545453,54,43,11
27,8,1.0,0.6363636363636364,54,43,11
27,9,1.0,0.36363636363636365,53,42,11
27,10,1.0,0.5454545454545454,53,42,11
27,11,1.0,0.45454545454545453,53,42,11
27,12,1.0,0.6363636363636364,52,41,11
27,13,1.0,0.4,49,39,10
27,14,1.0,0.2222222222222222,43,34,9
27,15,1.0,0.3333333333333333,35,29,6
27,16,1.0,0.4,31,26,5
27,17,1.0,0.4,29,24,5
27,18,1.0,0.5,27,23,4
27,19,1.0,0.5,25,21,4
27,20,1.0,0.75,24,20,4
27,21,1.0,0.5,23,19,4
27,22,1.0,0.5,22,18,4
27,23,1.0,1.0,20,17,3
28,0,1.0,0.45454545454545453,55,44,11
28,1,1.0,0.5454545454545454,55,44,11
28,2,1.0,0.5454545454545454,55,44,11
28,3,1.0,0.36363636363636365,55,44,11
28,4,1.0,0.5454545454545454,55,44,11
28,5,1.0,0.5454545454545454,55,44,11
28,6,1.0,0.5454545454545454,54,43,11
28,7,1.0,0.45454545454545453,54,43,11
28,8,1.0,0.7272727272727273,54,43,11
28,9,1.0,0.45454545454545453,53,42,11
28,10,1.0,0.5454545454545454,53,42,11
28,11,1.0,0.45454545454545453,53,42,11
28,12,1.0,0.5454545454545454,52,41,11
28,13,1.0,0.6,49,39,10
28,14,1.0,0.2222222222222222,43,34,9
28,15,1.0,0.3333333333333333,35,29,6
28,16,1.0,0.4,31,26,5
28,17,1.0,0.4,29,24,5
28,18,1.0,0.5,27,23,4
28,19,1.0,0.5,25,21,4
28,20,1.0,0.5,24,20,4
28,21,1.0,0.5,23,19,4
28,22,1.0,0.5,22,18,4
28,23,1.0,0.6666666666666666,20,17,3
29,0,1.0,0.5454545454545454,55,44,11
29,1,1.0,0.45454545454545453,55,44,11
29,2,1.0,0.5454545454545454,55,44,11
29,3,1.0,0.45454545454545453,55,44,11
29,4,1.0,0.6363636363636364,55,44,11
29,5,1.0,0.6363636363636364,55,44,11
29,6,1.0,0.5454545454545454,54,43,11
29,7,1.0,0.36363636363636365,54,43,11
29,8,1.0,0.6363636363636364,54,43,11
29,9,1.0,0.36363636363636365,53,42,11
29,10,1.0,0.5454545454545454,53,42,11
29,11,1.0,0.45454545454545453,53,42,11
29,12,1.0,0.6363636363636364,52,41,11
29,13,1.0,0.7,49,39,10
29,14,1.0,0.3333333333333333,43,34,9
29,15,1.0,0.3333333333333333,35,29,6
29,16,1.0,0.4,31,26,5
29,17,1.0,0.4,29,24,5
29,18,1.0,0.5,27,23,4
29,19,1.0,0.5,25,21,4
29,20,1.0,0.5,24,20,4
29,21,1.0,0.5,23,19,4
29,22,1.0,0.5,22,18,4
29,23,1.0,0.6666666666666666,20,17,3
30,0,1.0,0.5454545454545454,55,44,11
30,1,1.0,0.45454545454545453,55,44,11
30,2,1.0,0.5454545454545454,55,44,11
30,3,1.0,0.5454545454545454,55,44,11
30,4,1.0,0.6363636363636364,55,44,11
30,5,1.0,0.6363636363636364,55,44,11
30,6,1.0,0.6363636363636364,54,43,11
30,7,1.0,0.45454545454545453,54,43,11
30,8,1.0,0.5454545454545454,54,43,11
30,9,1.0,0.36363636363636365,53,42,11
30,10,1.0,0.5454545454545454,53,42,11
30,11,1.0,0.5454545454545454,53,42,11
30,12,1.0,0.5454545454545454,52,41,11
30,13,1.0,0.7,49,39,10
30,14,1.0,0.2222222222222222,43,34,9
30,15,1.0,0.3333333333333333,35,29,6
30,16,1.0,0.4,31,26,5
30,17,1.0,0.4,29,24,5
30,18,1.0,0.5,27,23,4
30,19,1.0,0.5,25,21,4
30,20,1.0,0.5,24,20,4
30,21,1.0,0.5,23,19,4
30,22,1.0,0.5,22,18,4
30,23,1.0,0.6666666666666666,20,17,3
31,0,1.0,0.5454545454545454,55,44,11
31,1,1.0,0.5454545454545454,55,44,11
31,2,1.0,0.5454545454545454,55,44,11
31,3,1.0,0.45454545454545453,55,44,11
31,4,1.0,0.6363636363636364,55,44,11
31,5,1.0,0.6363636363636364,55,44,11
31,6,1.0,0.6363636363636364,54,43,11
31,7,1.0,0.5454545454545454,54,43,11
31,8,1.0,0.5454545454545454,54,43,11
31,9,1.0,0.45454545454545453,53,42,11
31,10,1.0,0.5454545454545454,53,42,11
31,11,1.0,0.5454545454545454,53,42,11
31,12,1.0,0.5454545454545454,52,41,11
31,13,1.0,0.6,49,39,10
31,14,1.0,0.3333333333333333,43,34,9
31,15,1.0,0.3333333333333333,35,29,6
31,16,1.0,0.6,31,26,5
31,17,1.0,0.4,29,24,5
31,18,1.0,0.5,27,23,4
31,19,1.0,0.5,25,21,4
31,20,1.0,0.5,24,20,4
31,21,1.0,0.5,23,19,4
31,22,1.0,0.5,22,18,4
31,23,1.0,0.6666666666666666,20,17,3
32,0,1.0,0.5454545454545454,55,44,11
32,1,1.0,0.6363636363636364,55,44,11
32,2,1.0,0.6363636363636364,55,44,11
32,3,1.0,0.45454545454545453,55,44,11
32,4,1.0,0.5454545454545454,55,44,11
32,5,1.0,0.6363636363636364,55,44,11
32,6,1.0,0.6363636363636364,54,43,11
32,7,1.0,0.6363636363636364,54,43,11
32,8,1.0,0.5454545454545454,54,43,11
32,9,1.0,0.45454545454545453,53,42,11
32,10,1.0,0.5454545454545454,53,42,11
32,11,1.0,0.5454545454545454,53,42,11
32,12,1.0,0.5454545454545454,52,41,11
32,13,1.0,0.6,49,39,10
32,14,1.0,0.3333333333333333,43,34,9
32,15,1.0,0.3333333333333333,35,29,6
32,16,1.0,0.8,31,26,5
32,17,1.0,0.4,29,24,5
32,18,1.0,0.5,27,23,4
32,19,1.0,0.5,25,21,4
32,20,1.0,0.5,24,20,4
32,21,1.0,0.5,23,19,4
32,22,1.0,0.5,22,18,4
32,23,1.0,0.6666666666666666,20,17,3
33,0,1.0,0.5454545454545454,55,44,11
33,1,1.0,0.5454545454545454,55,44,11
33,2,1.0,0.6363636363636364,55,44,11
33,3,1.0,0.5454545454545454,55,44,11
33,4,1.0,0.7272727272727273,55,44,11
33,5,1.0,0.6363636363636364,55,44,11
33,6,1.0,0.6363636363636364,54,43,11
33,7,1.0,0.5454545454545454,54,43,11
33,8,1.0,0.45454545454545453,54,43,11
33,9,1.0,0.45454545454545453,53,42,11
33,10,1.0,0.5454545454545454,53,42,11
33,11,1.0,0.5454545454545454,53,42,11
33,12,1.0,0.5454545454545454,52,41,11
33,13,1.0,0.6,49,39,10
33,14,1.0,0.2222222222222222,43,34,9
33,15,1.0,0.3333333333333333,35,29,6
33,16,1.0,0.8,31,26,5
33,17,1.0,0.4,29,24,5
33,18,1.0,0.5,27,23,4
33,19,1.0,0.5,25,21,4
33,20,1.0,0.5,24,20,4
33,21,1.0,0.5,23,19,4
33,22,1.0,0.5,22,18,4
33,23,1.0,0.6666666666666666,20,17,3
34,0,1.0,0.5454545454545454,55,44,11
34,1,1.0,0.45454545454545453,55,44,11
34,2,1.0,0.6363636363636364,55,44,11
34,3,1.0,0.5454545454545454,55,44,11
34,4,1.0,0.7272727272727273,55,44,11
34,5,1.0,0.5454545454545454,55,44,11
34,6,1.0,0.6363636363636364,54,43,11
34,7,1.0,0.6363636363636364,54,43,11
34,8,1.0,0.45454545454545453,54,43,11
34,9,1.0,0.45454545454545453,53,42,11
34,10,1.0,0.5454545454545454,53,42,11
34,11,1.0,0.5454545454545454,53,42,11
34,12,1.0,0.6363636363636364,52,41,11
34,13,1.0,0.6,49,39,10
34,14,1.0,0.2222222222222222,43,34,9
34,15,1.0,0.3333333333333333,35,29,6
34,16,1.0,0.6,31,26,5
34,17,1.0,0.4,29,24,5
34,18,1.0,0.5,27,23,4
34,19,1.0,0.5,25,21,4
34,20,1.0,0.5,24,20,4
34,21,1.0,0.5,23,19,4
34,22,1.0,0.5,22,18,4
34,23,1.0,0.6666666666666666,20,17,3
35,0,1.0,0.5454545454545454,55,44,11
35,1,1.0,0.45454545454545453,55,44,11
35,2,1.0,0.6363636363636364,55,44,11
35,3,1.0,0.45454545454545453,55,44,11
35,4,1.0,0.7272727272727273,55,44,11
35,5,1.0,0.6363636363636364,55,44,11
35,6,1.0,0.6363636363636364,54,43,11
35,7,1.0,0.5454545454545454,54,43,11
35,8,1.0,0.45454545454545453,54,43,11
35,9,1.0,0.45454545454545453,53,42,11
35,10,1.0,0.6363636363636364,53,42,11
35,11,1.0,0.5454545454545454,53,42,11
35,12,1.0,0.5454545454545454,52,41,11
35,13,1.0,0.6,49,39,10
35,14,1.0,0.2222222222222222,43,34,9
35,15,1.0,0.3333333333333333,35,29,6
35,16,1.0,0.6,31,26,5
35,17,1.0,0.4,29,24,5
35,18,1.0,0.5,27,23,4
35,19,1.0,0.5,25,21,4
35,20,1.0,0.5,24,20,4
35,21,1.0,0.5,23,19,4
35,22,1.0,0.5,22,18,4
35,23,1.0,0.6666666666666666,20,17,3
36,0,1.0,0.5454545454545454,55,44,11
36,1,1.0,0.45454545454545453,55,44,11
36,2,1.0,0.6363636363636364,55,44,11
36,3,1.0,0.5454545454545454,55,44,11
36,4,1.0,0.6363636363636364,55,44,11
36,5,1.0,0.6363636363636364,55,44,11
36,6,1.0,0.6363636363636364,54,43,11
36,7,1.0,0.5454545454545454,54,43,11
36,8,1.0,0.36363636363636365,54,43,11
36,9,1.0,0.45454545454545453,53,42,11
36,10,1.0,0.6363636363636364,53,42,11
36,11,1.0,0.5454545454545454,53,42,11
36,12,1.0,0.5454545454545454,52,41,11
36,13,1.0,0.6,49,39,10
36,14,1.0,0.4444444444444444,43,34,9
36,15,1.0,0.3333333333333333,35,29,6
36,16,1.0,0.6,31,26,5
36,17,1.0,0.4,29,24,5
36,18,1.0,0.5,27,23,4
36,19,1.0,0.5,25,21,4
36,20,1.0,0.5,24,20,4
36,21,1.0,0.5,23,19,4
36,22,1.0,0.5,22,18,4
36,23,1.0,0.6666666666666666,20,17,3
37,0,1.0,0.5454545454545454,55,44,11
37,1,1.0,0.45454545454545453,55,44,11
37,2,1.0,0.6363636363636364,55,44,11
37,3,1.0,0.5454545454545454,55,44,11
37,4,1.0,0.6363636363636364,55,44,11
37,5,1.0,0.6363636363636364,55,44,11
37,6,1.0,0.6363636363636364,54,43,11
37,7,1.0,0.5454545454545454,54,43,11
37,8,1.0,0.36363636363636365,54,43,11
37,9,1.0,0.45454545454545453,53,42,11
37,10,1.0,0.6363636363636364,53,42,11
37,11,1.0,0.5454545454545454,53,42,11
37,12,1.0,0.5454545454545454,52,41,11
37,13,1.0,0.6,49,39,10
37,14,1.0,0.3333333333333333,43,34,9
37,15,1.0,0.3333333333333333,35,29,6
37,16,1.0,0.6,31,26,5
37,17,1.0,0.4,29,24,5
37,18,1.0,0.5,27,23,4
37,19,1.0,0.5,25,21,4
37,20,1.0,0.5,24,20,4
37,21,1.0,0.5,23,19,4
37,22,1.0,0.5,22,18,4
37,23,1.0,0.3333333333333333,20,17,3
38,0,1.0,0.5454545454545454,55,44,11
38,1,1.0,0.45454545454545453,55,44,11
38,2,1.0,0.6363636363636364,55,44,11
38,3,1.0,0.6363636363636364,55,44,11
38,4,1.0,0.7272727272727273,55,44,11
38,5,1.0,0.6363636363636364,55,44,11
38,6,1.0,0.6363636363636364,54,43,11
38,7,1.0,0.6363636363636364,54,43,11
38,8,1.0,0.36363636363636365,54,43,11
38,9,1.0,0.45454545454545453,53,42,11
38,10,1.0,0.6363636363636364,53,42,11
38,11,1.0,0.5454545454545454,53,42,11
38,12,1.0,0.5454545454545454,52,41,11
38,13,1.0,0.6,49,39,10
38,14,1.0,0.3333333333333333,43,34,9
38,15,1.0,0.3333333333333333,35,29,6
38,16,1.0,0.6,31,26,5
38,17,1.0,0.4,29,24,5
38,18,1.0,0.5,27,23,4
38,19,1.0,0.5,25,21,4
38,20,1.0,0.5,24,20,4
38,21,1.0,0.5,23,19,4
38,22,1.0,0.5,22,18,4
38,23,1.0,0.3333333333333333,20,17,3
39,0,1.0,0.5454545454545454,55,44,11
39,1,1.0,0.45454545454545453,55,44,11
39,2,1.0,0.6363636363636364,55,44,11
39,3,1.0,0.45454545454545453,55,44,11
39,4,1.0,0.7272727272727273,55,44,11
39,5,1.0,0.6363636363636364,55,44,11
39,6,1.0,0.6363636363636364,54,43,11
39,7,1.0,0.5454545454545454,54,43,11
39,8,1.0,0.36363636363636365,54,43,11
39,9,1.0,0.45454545454545453,53,42,11
39,10,1.0,0.5454545454545454,53,42,11
39,11,1.0,0.5454545454545454,53,42,11
39,12,1.0,0.5454545454545454,52,41,11
39,13,1.0,0.6,49,39,10
39,14,1.0,0.2222222222222222,43,34,9
39,15,1.0,0.3333333333333333,35,29,6
39,16,1.0,0.6,31,26,5
39,17,1.0,0.4,29,24,5
39,18,1.0,0.5,27,23,4
39,19,1.0,0.5,25,21,4
39,20,1.0,0.5,24,20,4
39,21,1.0,0.5,23,19,4
39,22,1.0,0.5,22,18,4
39,23,1.0,0.3333333333333333,20,17,3
40,0,1.0,0.5454545454545454,55,44,11
40,1,1.0,0.45454545454545453,55,44,11
40,2,1.0,0.6363636363636364,55,44,11
40,3,1.0,0.5454545454545454,55,44,11
40,4,1.0,0.7272727272727273,55,44,11
40,5,1.0,0.6363636363636364,55,44,11
40,6,1.0,0.6363636363636364,54,43,11
40,7,1.0,0.5454545454545454,54,43,11
40,8,1.0,0.36363636363636365,54,43,11
40,9,1.0,0.36363636363636365,53,42,11
40,10,1.0,0.6363636363636364,53,42,11
40,11,1.0,0.5454545454545454,53,42,11
40,12,1.0,0.5454545454545454,52,41,11
40,13,1.0,0.7,49,39,10
40,14,1.0,0.3333333333333333,43,34,9
40,15,1.0,0.3333333333333333,35,29,6
40,16,1.0,0.6,31,26,5
40,17,1.0,0.4,29,24,5
40,18,1.0,0.5,27,23,4
40,19,1.0,0.5,25,21,4
40,20,1.0,0.5,24,20,4
40,21,1.0,0.5,23,19,4
40,22,1.0,0.5,22,18,4
40,23,1.0,0.3333333333333333,20,17,3
41,0,1.0,0.5454545454545454,55,44,11
41,1,1.0,0.45454545454545453,55,44,11
41,2,1.0,0.6363636363636364,55,44,11
41,3,1.0,0.5454545454545454,55,44,11
41,4,1.0,0.7272727272727273,55,44,11
41,5,1.0,0.6363636363636364,55,44,11
41,6,1.0,0.6363636363636364,54,43,11
41,7,1.0,0.5454545454545454,54,43,11
41,8,1.0,0.45454545454545453,54,43,11
41,9,1.0,0.36363636363636365,53,42,11
41,10,1.0,0.5454545454545454,53,42,11
41,11,1.0,0.5454545454545454,53,42,11
41,12,1.0,0.45454545454545453,52,41,11
41,13,1.0,0.7,49,39,10
41,14,1.0,0.3333333333333333,43,34,9
41,15,1.0,0.5,35,29,6
41,16,1.0,0.4,31,26,5
41,17,1.0,0.4,29,24,5
41,18,1.0,0.5,27,23,4
41,19,1.0,0.5,25,21,4
41,20,1.0,0.5,24,20,4
41,21,1.0,0.5,23,19,4
41,22,1.0,0.5,22,18,4
41,23,1.0,0.3333333333333333,20,17,3
42,0,1.0,0.5454545454545454,55,44,11
42,1,1.0,0.45454545454545453,55,44,11
42,2,1.0,0.6363636363636364,55,44,11
42,3,1.0,0.45454545454545453,55,44,11
42,4,1.0,0.7272727272727273,55,44,11
42,5,1.0,0.6363636363636364,55,44,11
42,6,1.0,0.6363636363636364,54,43,11
42,7,1.0,0.5454545454545454,54,43,11
42,8,1.0,0.36363636363636365,54,43,11
42,9,1.0,0.36363636363636365,53,42,11
42,10,1.0,0.6363636363636364,53,42,11
42,11,1.0,0.5454545454545454,53,42,11
42,12,1.0,0.45454545454545453,52,41,11
42,13,1.0,0.6,49,39,10
42,14,1.0,0.3333333333333333,43,34,9
42,15,1.0,0.5,35,29,6
42,16,1.0,0.4,31,26,5
42,17,1.0,0.4,29,24,5
42,18,1.0,0.5,27,23,4
42,19,1.0,0.5,25,21,4
42,20,1.0,0.5,24,20,4
42,21,1.0,0.5,23,19,4
42,22,1.0,0.5,22,18,4
42,23,1.0,0.3333333333333333,20,17,3
43,0,1.0,0.5454545454545454,55,44,11
43,1,1.0,0.45454545454545453,55,44,11
43,2,1.0,0.6363636363636364,55,44,11
43,3,1.0,0.45454545454545453,55,44,11
43,4,1.0,0.7272727272727273,55,44,11
43,5,1.0,0.5454545454545454,55,44,11
43,6,1.0,0.45454545454545453,54,43,11
43,7,1.0,0.45454545454545453,54,43,11
43,8,1.0,0.36363636363636365,54,43,11
43,9,1.0,0.36363636363636365,53,42,11
43,10,1.0,0.6363636363636364,53,42,11
43,11,1.0,0.5454545454545454,53,42,11
43,12,1.0,0.45454545454545453,52,41,11
43,13,1.0,0.5,49,39,10
43,14,1.0,0.3333333333333333,43,34,9
43,15,1.0,0.5,35,29,6
43,16,1.0,0.4,31,26,5
43,17,1.0,0.4,29,24,5
43,18,1.0,0.5,27,23,4
43,19,1.0,0.5,25,21,4
43,20,1.0,0.5,24,20,4
43,21,1.0,0.5,23,19,4
43,22,1.0,0.5,22,18,4
43,23,1.0,0.3333333333333333,20,17,3
44,0,1.0,0.5454545454545454,55,44,11
44,1,1.0,0.45454545454545453,55,44,11
44,2,1.0,0.6363636363636364,55,44,11
44,3,1.0,0.45454545454545453,55,44,11
44,4,1.0,0.7272727272727273,55,44,11
44,5,1.0,0.5454545454545454,55,44,11
44,6,1.0,0.6363636363636364,54,43,11
44,7,1.0,0.5454545454545454,54,43,11
44,8,1.0,0.36363636363636365,54,43,11
44,9,1.0,0.36363636363636365,53,42,11
44,10,1.0,0.5454545454545454,53,42,11
44,11,1.0,0.5454545454545454,53,42,11
44,12,1.0,0.45454545454545453,52,41,11
44,13,1.0,0.5,49,39,10
44,14,1.0,0.3333333333333333,43,34,9
44,15,1.0,0.5,35,29,6
44,16,1.0,0.4,31,26,5
44,17,1.0,0.4,29,24,5
44,18,1.0,0.5,27,23,4
44,19,1.0,0.5,25,21,4
44,20,1.0,0.5,24,20,4
44,21,1.0,0.5,23,19,4
44,22,1.0,0.5,22,18,4
44,23,1.0,0.3333333333333333,20,17,3
45,0,1.0,0.5454545454545454,55,44,11
45,1,1.0,0.45454545454545453,55,44,11
45,2,1.0,0.6363636363636364,55,44,11
45,3,1.0,0.36363636363636365,55,44,11
45,4,1.0,0.7272727272727273,55,44,11
45,5,1.0,0.45454545454545453,55,44,11
45,6,1.0,0.45454545454545453,54,43,11
45,7,1.0,0.5454545454545454,54,43,11
45,8,1.0,0.36363636363636365,54,43,11
45,9,1.0,0.36363636363636365,53,42,11
45,10,1.0,0.5454545454545454,53,42,11
45,11,1.0,0.6363636363636364,53,42,11
45,12,1.0,0.36363636363636365,52,41,11
45,13,1.0,0.7,49,39,10
45,14,1.0,0.3333333333333333,43,34,9
45,15,1.0,0.5,35,29,6
45,16,1.0,0.6,31,26,5
45,17,1.0,0.4,29,24,5
45,18,1.0,0.5,27,23,4
45,19,1.0,0.5,25,21,4
45,20,1.0,0.5,24,20,4
45,21,1.0,0.5,23,19,4
45,22,1.0,0.5,22,18,4
45,23,1.0,0.3333333333333333,20,17,3
46,0,1.0,0.5454545454545454,55,44,11
46,1,1.0,0.45454545454545453,55,44,11
46,2,1.0,0.6363636363636364,55,44,11
46,3,1.0,0.36363636363636365,55,44,11
46,4,1.0,0.6363636363636364,55,44,11
46,5,1.0,0.45454545454545453,55,44,11
46,6,1.0,0.45454545454545453,54,43,11
46,7,1.0,0.6363636363636364,54,43,11
46,8,1.0,0.45454545454545453,54,43,11
46,9,1.0,0.36363636363636365,53,42,11
46,10,1.0,0.5454545454545454,53,42,11
46,11,1.0,0.5454545454545454,53,42,11
46,12,1.0,0.36363636363636365,52,41,11
46,13,1.0,0.7,49,39,10
46,14,1.0,0.3333333333333333,43,34,9
46,15,1.0,0.5,35,29,6
46,16,1.0,0.6,31,26,5
46,17,1.0,0.4,29,24,5
46,18,1.0,0.5,27,23,4
46,19,1.0,0.5,25,21,4
46,20,1.0,0.5,24,20,4
46,21,1.0,0.5,23,19,4
46,22,1.0,0.5,22,18,4
46,23,1.0,0.3333333333333333,20,17,3
47,0,1.0,0.5454545454545454,55,44,11
47,1,1.0,0.45454545454545453,55,44,11
47,2,1.0,0.6363636363636364,55,44,11
47,3,1.0,0.36363636363636365,55,44,11
47,4,1.0,0.5454545454545454,55,44,11
47,5,1.0,0.45454545454545453,55,44,11
47,6,1.0,0.45454545454545453,54,43,11
47,7,1.0,0.6363636363636364,54,43,11
47,8,1.0,0.45454545454545453,54,43,11
47,9,1.0,0.45454545454545453,53,42,11
47,10,1.0,0.5454545454545454,53,42,11
47,11,1.0,0.5454545454545454,53,42,11
47,12,1.0,0.5454545454545454,52,41,11
47,13,1.0,0.6,49,39,10
47,14,1.0,0.3333333333333333,43,34,9
47,15,1.0,0.5,35,29,6
47,16,1.0,0.6,31,26,5
47,17,1.0,0.4,29,24,5
47,18,1.0,0.5,27,23,4
47,19,1.0,0.5,25,21,4
47,20,1.0,0.5,24,20,4
47,21,1.0,0.5,23,19,4
47,22,1.0,0.5,22,18,4
47,23,1.0,0.3333333333333333,20,17,3
